    XXXXX             e
    X   X             e
    X*  X             e
  XXX  *XXX           e
  X  *  * X           e
XXX X XXX X     XXXXXXe
X   X XXX XXXXXXX  ..Xe
X *  *             ..Xe
XXXXX XXXX X@XXXX  ..Xe
    X      XXX  XXXXXXe
    XXXXXXXX          e